 XXXXXXXXXXXX
 X  XXXXXX  X
 X  X    X  X
 X  XX XXX  X
 X  X       X
 X  X SX X  X
 X  X XX X  X
 X  X    X  X
 X  X XXXX  X
 X    X   XXX
     XX    FX
 XXXXXXXXXX X
 