XXXXXXXXXXXXXXX
X    XXX      X
X    XXX      X
X    X        X
X    XXXXXXX  X
X    X X   X  X
XXXXXX X X X  X
X      S X X  X
X  XXXXX X X  X
X  X   X X X  X
X  X X   X X  X
X  X XXXXX X  X
X  X     XXXX X
X  XXXXX    XFX
XXXXXXXXXXXXXXX