XXXXXXXXXXFXXXXXXXX
X                 X  
X      XXXXXXX    X     
X      X     X    X 
X      X XSX X    X 
XXXXXXXX XXX X    X 
X        XXX      X
XXXXXXXXXXXXXXXXXXX