XXXXXX 
XXXX
X SX X
X XF X
X  XXX
XX XXX
